+++++++++++++++
+             +
+++++++++++++ +
+         A0  +
+ +++++++++++++
+             +
+++++++++++++ +
+             +
+ +++++++++++++
+             +
+++++++++++++ +
+             +
+ +++++++++++++
+ +   +   +   +
+   +   +   +a+
+++++++++++++++