+++++++++++++++
+             +
+++++++++++++ +
+             +
+ +++++++++++++
+             +
+++++++++++++ +
+             +
+ +++++++++++++
+             +
+++++++++++++ +
+             +
+ +++++++++++++
+ +  0+   +   +
+   +A  +   +a+
+++++++++++++++