+++++++++++++++
+             +
+++++++++++++ +
+             +
+ +++++++++++++
+             +
+++++++++++++ +
+             +
+ +++++++++++++
+             +
+++++++++++++ +
+             +
+ +++++++++++++
+ +   +   +   +
+   +   + 0A+a+
+++++++++++++++