+++++++++++++++
+             +
+++++++++++++ +
+             +
+ +++++++++++++
+             +
+++++++++++++ +
+             +
+ +++++++++++++
+             +
+++++++++++++ +
+             +
+ +++++++++++++
+ +   +   +   +
+0A +   +   +a+
+++++++++++++++