++++++++++
+0A      +
+       ++
+      + +
+  a  +  +
+        +
+ +++++  +
+        +
+   +    +
+ +++++  +
+  +     +
+    +++ +
+      + +
+     +  +
+   ++   +
++++++++++