++++++++
+0A    +
+      +
+  ++  +
+ +  + +
++     +
+     ++
+    + +
+   ++ +
+ +++  +
+  a+  +
+  ++  +
+   +  +
+      +
+      +
++++++++