++++++++++++++
+0A          +
+            +
+ ++++       +
+  ++        +
+       +    +
+++++++++    +
+   +        +
+            +
+    +       +
+    a++     +
+  +++++     +
+            +
++++++++++++++