+++++++++++
+0A       +
+         +
+   +++++++
+         +
+++++++++ +
+         +
+   +++++++
+         +
+        a+
+++++++++++