+++++++++++
+0A       +
+         +
+         +
++++++    +
+         +
+         +
+     +++++
+         +
++++      +
+         +
+        a+
+++++++++++