+++++++++++++
+0A         +
+    + +    +
+ + +  +    +
+  +   +    +
+ +    +    +
++     +    +
+      +    +
+      +    +
+      +    +
+      +    +
+ ++++++    +
+       a   +
+           +
+           +
+++++++++++++