+++++++++++++
+0A         +
+           +
+           +
+           +
+           +
+           +
+++++++     +
+     +     +
+  +  +     +
+  + a+     +
+  ++++     +
+           +
+++++++++++++