+++++++++++++
+0A  +      +
+    + +    +
+    + +    +
+    +a+    +
+  + + +    +
+   ++ +    +
+    + +    +
+   +  +    +
+  +   +    +
+           +
+++++++++++++