++++++++++++
+0A        +
+    +     +
+    +     +
+    +     +
+    +++++++
+    +a    +
+    +     +
+    +     +
+    +     +
+          +
++++++++++++