++++++++
+0A    +
+      +
+ ++++++
+ +    +
+ +    +
+ +    +
+ +    +
+ +    +
+ ++++++
+     a+
++++++++