+++++++++
+0A     +
+    +  +
+  +    +
+ +     +
+       +
+++++++ +
+  +    +
+a  + + +
+       +
+++++++++