+++++++++++++++
+0A           +
+  +++++++    +
+ +   ++++    +
++ +++++++    +
++++++++++    +
++++++++++    +
+      + +    +
+   a   +     +
+       +     +
+             +
+++++++++++++++