+++++++++++++++
+0A  +        +
+     ++      +
+       +     +
+        ++   +
+   +         +
+  +         ++
+ +  +       ++
++          +a+
+     +       +
+      ++ ++  +
+        +    +
+ ++++++      +
+             +
+             +
+++++++++++++++