+++++++++++
+0A    +  +
+     +   +
+    +    +
+   +     +
+         +
+  +      +
+         +
+         +
+       + +
+      +  +
+++ ++++  +
+     +   +
+     +  a+
+++++++++++