+++++++++
+0A     +
+ +   + +
+  + +  +
+   +   +
+   +   +
+  + +  +
+ +   + +
+  +++  +
+   a   +
+       +
+++++++++