++++++++++++
+0A        +
+       +  +
+      +   +
+     +    +
+    +     +
+++++      +
+          +
+   +      +
+    +++   +
+ +  a+    +
+   ++     +
+          +
++++++++++++