++++++++++++++++
+0A    + + +   +
+     +a       +
+       + +    +
++++++++++++++++