++++++++++++++++
+0A            +
+   ++++++++   +
+    a +++     +
+              +
++++++++++++++++
