++++++++++++
+0A        +
+    +  +  +
+  +++++a  +
+    +  +  +
+          +
++++++++++++