+++++++++++
+ a   +   +
+      +  +
+   + +   +
+        ++
+ 0A +    +
+     +   +
+         +
+++++++++++