++++++++++++++++
+0A    +       +
+  + +++  +++  +
+  +   +a  +   +
+   +  +    +  +
+    + +     + +
+     +++++++  +
+              +
++++++++++++++++