+++++++++++++++
+0A           +
++++++++++    +
+             +
+    ++++++++++
+             +
+++++++++     +
+            a+
+++++++++++++++