+++++++++++++++
+0A        +  +
+    +   +  + +
+    ++++     +
+    +        +
+ ++++  +++   +
+  + + a+   + +
+  + ++++  +  +
+         +   +
+++++++++++++++