+++++++++++++
+0A         +
+           +
+           +
+           +
+           +
+           +
+           +
+           +
+          a+
+++++++++++++