+++++++++
+0A     +
+       +
+       +
+       +
+       +
+       +
+      a+
+++++++++