++++++++
+A     +
+      +
+   a  +
+      +
+      +
+     0+
++++++++