++++++++
+      +
+  A   +
+   a  +
+      +
+     0+
+      +
++++++++