++++++++
+      +
+      +
+      +
+      +
+   0  +
+   A a+
++++++++