+++++++++
+  a    +
+       +
+   +++++
+       +
+++   A +
+     0 +
+       +
+++++++++