+++++++++
+       +
+       +
+   +++++
+  0A   +
+++     +
+       +
+a      +
+++++++++