+++++++++
+   0   +
+       +
+   +++++
+      A+
+++ a   +
+       +
+       +
+++++++++