+++++++++
+  a    +
+       +
+   +++++
+   A0  +
+++     +
+       +
+       +
+++++++++