++++++++++
+        +
+        +
+0       +
+A       +
+        +
+        +
+        +
+a       +
++++++++++