+++++++++++
+  0      +
+A        +
+         +
+         +
+         +
+         +
+         +
+a        +
+++++++++++