++++++++++
+        +
+        +
+        +
+0A      +
+        +
+        +
+        +
+a       +
++++++++++