+++++++++++
+         +
+0        +
+A        +
+         +
+         +
+         +
+         +
+a        +
+++++++++++