+++++++++++
+      0  +
+A        +
+         +
+         +
+         +
+         +
+         +
+a        +
+++++++++++