++++++++++++
+0         +
+    a     +
+          +
+++++++    +
+          +
+   +      +
+   +      +
+   ++++++++
+          +
+     A    +
++++++++++++