++++++++++++
+    0     +
+    a  A  +
+          +
+++++++    +
+          +
+   +      +
+   +      +
+   ++++++++
+          +
+          +
++++++++++++