++++++++++++
+    0     +
+    a     +
+          +
+++++++    +
+          +
+   +      +
+   +  A   +
+   ++++++++
+          +
+          +
++++++++++++