+++++++++++++
+     a     +
+           +
+           +
+++++++     +
+           +
+   +       +
+   +       +
+   +++++A+++
+        0  +
+  ++       +
+   +       +
+++++++++++++