+++++++++++++
+     a     +
+           +
+           +
+++++++     +
+           +
+   +       +
+ A +       +
+   +++++0+++
+           +
+  ++       +
+   +       +
+++++++++++++