++++++++++++++
+     a      +
+            +
+ A          +
++  +++      +
+            +
+   +        +
+   +        +
+        +   +
+            +
+  ++   +    +
+  0+   ++   +
+            +
++++++++++++++