++++++++++++++
+    Aa      +
+            +
+            +
++  +++      +
+            +
+   +        +
+   +        +
+        +   +
+            +
+  ++   +    +
+  0+   ++   +
+            +
++++++++++++++