++++++++++++++++
+      0       +
+              +
+              +
++  +++  +     +
+       +  A   +
+   +   +      +
+   +   ++++++ +
+        +     +
+              +
+  ++   +      +
+   +   ++     +
+  +           +
+     a        +
+              +
++++++++++++++++