+++++++++++++++
+             +
+    ++++++   +
+    +A   +   +
+    +b   +   +
+    +++  +   +
+      +  +   +
+  +   +  +   +
+  +   +  +   +
+  +   +  +   +
+  +   +  +   +
+  +   +  +   +
+  +a B+  +   +
+  +++++  +   +
+         +  0+
+++++++++++++++