++++++++++++++
+         + A+
+      + a+  +
+      ++++  +
+         +  +
+++++        +
+            +
+            +
+     0+     +
+     +++    +
+      +     +
+            +
++++ ++      +
+            +
+            +
++++++++++++++