+++++++++++++++
+             +
+    ++++++   +
+    +    +   +
+    +A   +   +
+    +++  +   +
+      +  +   +
+  +   +  +   +
+  +   +  +   +
+  +   +  +   +
+  +   +  +   +
+  +   +  +   +
+  +  a+  +   +
+  +++++  +   +
+         +  0+
+++++++++++++++