+++++++++++++++
+0A           +
+             +
+   ++++++    +
+   ++++++    +
+   ++++++    +
+   ++++++    +
+   ++++++    +
+   ++++++    +
+   ++++++    +
+             +
+            a+
+++++++++++++++