++++++++
+0A    +
+      +
+   +  +
+  ++  +
+ + +  +
++  +  +
+   ++ +
+   +a +
+  ++  +
+  ++  +
+  +   +
+      +
+      +
++++++++