++++++++++++++
+0A          +
+       ++   +
+ +       ++ +
+  ++        +
+    +       +
++++++++++   +
+       a+   +
+      ++    +
+    ++++  + +
+            +
+            +
++++++++++++++