++++++++++++++++
+0A            +
+              +
+              +
+    ++++++    +
+          +   +
+   + + + +    +
+   +  a +     +
+    +  +      +
+     ++       +
+              +
++++++++++++++++