++++++++++
+0A      +
+        +
+        +
+     +  +
+    +   +
+++++    +
+    +   +
+     +  +
+      + +
+        +
+       a+
++++++++++