+++++++++
+0A     +
+       +
+       +
+       +
+   a   +
+       +
+       +
+       +
+       +
+       +
+       +
+       +
+++++++++