++++++++++++++++
+0A            +
+       +      +
+ a    +       +
+    ++        +
+++++          +
+              +
+       +      +
+              +
+        ++    +
+   +          +
+          +   +
+              +
++++++++++++++++