+++++++++++
+0A       +
+    +++  +
+         +
+   +++++ +
+         +
+++++     +
+         +
+      +  +
+   ++++  +
++   +++  +
+++  a++  +
+++++  +  +
++++++    +
+++++++   +
+++++++++++