++++++++++++++
+0A          +
+   +++      +
+  +  a+     +
+     +      +
+     +     ++
+     +    +++
+     +   ++++
+     +  +++++
+       ++++++
+      +++++++
++++++++++++++