+++++++++++
+0A       +
+   + + + +
+  + + +  +
+   + + + +
+  + + + ++
+   + + +a+
+    + +  +
+   + +   +
+  + +    +
+         +
+++++++++++