++++++++++
+0A      +
+  +++   +
+ +++++  +
+   a    +
++++++++++
