++++++++
+0A    +
+++++  +
+     ++
+     a+
++++++++
