+++++++++
+0A     +
+  + +  +
+ + +a  +
+   +   +
+++++++++
