++++++++++++++++
+0A        +   +
+    + a+     ++
+   +          +
+  +  +   +  + +
+              +
++++++++++++++++