++++++++++
+0A      +
+   + +  +
++++++   +
+a       +
++++     +
+++      +
+++      +
++++++++++