++++++++++++++++
+0A         +  +
+   +   +  +   +
+  +   +  +    +
+ +   +  +     +
+    +  +      +
+ +++  +       +
++    +      +++
+             a+
++++++++++++++++