+++++++++++++
+0A         +
+      ++ + +
+ +      +  +
++ +    +   +
+   +       +
+    +      +
+     +     +
+          a+
+++++++++++++