++++++++++++++
+0A  + +     +
+         +  +
+  +        ++
+    +a +  + +
+         +  +
++++  + ++   +
+   ++++ +   +
+  +     +   +
++++++++++++++