blue: A,1
red: B,0
++++++++++
+      Aa+
+   1    +
+        +
+     ++++
+        +
+        +
+     ++++
+        +
+    0 Bb+
++++++++++