blue: A,0
red: B,1
++++++++++
+       a+
+        +
+        +
+     ++++
+  A 0   +
+  B 1   +
+     ++++
+        +
+       b+
++++++++++