blue: A,0
red: B,1
++++++++++
+       a+
+        +
+        +
+  A  ++++
+  0     +
+  1     +
+  B  ++++
+        +
+       b+
++++++++++