++++++++++++++++
+            0a+
+             A+
++++++++++++++++
+            1b+
+             B+
++++++++++++++++
+            2c+
+             C+
++++++++++++++++
+            3d+
+             D+
++++++++++++++++