red: A,B,0,1
blue: C,D,2,3
+++++++++++++++
+a    b+c    d+
+ A  B + C  D +
+ 0  1 + 2  3 +
+      +      +
+      +      +
+++++++++++++++