red: A,B,0,1
blue: C,D,2,3
+++++++++++++++
+aA  Bb+cC  Dd+
+ 0  1 + 2  3 +
+      +      +
+      +      +
+      +      +
+++++++++++++++