blue: A,0
red: B,1
++++++++++
+  A    a+
+  0     +
+        +
+     ++++
+        +
+        +
+     ++++
+        +
+  1B   b+
++++++++++