+++++++++++
+a   +   b+
++   +   ++
+++ A+B +++
++   +   ++
+ 0  +  1 +
+++++++++++