+++++++++++
+aA0 + 1Bb+
++   +   ++
+++  +  +++
++   +   ++
+    +    +
+++++++++++