+++++++++++++
+a          +
+ A         +
+           +
+           +
+           +
+           +
+        0B +
+          b+
+++++++++++++