+++++++++++++
+a          +
+ A         +
+           +
+           +
+     0     +
+           +
+         B +
+          b+
+++++++++++++