++++++++++
+0       +
+        +
++++++   +
+A   +   +
+  + +   +
+  +     +
+  +++++++
+       a+
++++++++++