++++++++++
+       A+
+       ++
+  a    +
+       +
+       +
+       +
+       +
+0+++++++
+++