blue: A,1
red: B,0
++++++++++
+    1 Aa+
+        +
+        +
+     ++++
+        +
+        +
+     ++++
+        +
+     0Bb+
++++++++++