blue: 0,A
red: 1,B
+++++++++
+   B   +
+   B   +
+   +   +
+   +   +
+   +   +
+   +   +
+ 1 +   +
+A  +   +
+0  +   +
+   +b a+
+++++++++