blue: 0,A
red: 1,B
+++++++++
+   B   +
+  0A   +
+   +1  +
+   +B  +
+   +   +
+   +   +
+   +   +
+   +   +
+   +   +
+   +b a+
+++++++++