+++++++++++++++
+             +
+ +++++++++++ +
+           + +
+ +++++++++ + +
+ +         + +
+ + +++++++ + +
+0+       + + +
+ +      a+A+ +
+ + +++++++ + +
+ +         + +
+ +++++++++ + +
+           + +
+ +++++++++++ +
+             +
+++++++++++++++