+++++++++++++++
+      0      +
+             +
+             +
+             +
+             +
+             +
+     AB      +
+  b     a    +
+             +
+             +
+             +
+             +
+             +
+             +
+++++++++++++++