++++++++++++++++
+0  + +        +
+ + + + +   ++ +
+ + + + + + ++ +
+ + +   +   ++ +
+ + + + +  +++ +
+ + + + ++  ++ +
+ +   +     ++ +
+ + + ++ +     +
+ + + +  +  +  +
+ + + + + +  + +
+ + + +  + +   +
+ + + + a+ + + +
+ + + +  + + + +
+A  +    +   + +
++++++++++++++++