+++++++++++++++
+             +
+    ++++++   +
+    +    +   +
+    +a   +   +
+    +++  +   +
+      +  +   +
+  +   +  +   +
+  +   +  +   +
+  +   +  +   +
+  +   +  +   +
+  +   +  +   +
+  +  A+  +   +
+  +++++  +   +
+         +  0+
+++++++++++++++