++++++++++
+a       +
+        +
++++++   +
+A   +   +
+  + +   +
+  +     +
+  +++++++
+       0+
++++++++++