+++++++++++
+         +
+ +0+ +A+ +
+ +++ +++ +
+ + + +a+ +
+         +
+++++++++++