++++++++
+a + a++
++ + +a+
+A + + +
+ 0 AA +
++++++++