+++++++++++++++
+0 +         a+
+            ++
+  +A       +++
+ +++A     ++++
+  +A     +++++
+           +++
+a           a+
+++++++++++++++