++++++++++++++
+0 + AAA +  a+
+ +++  +++ +a+
+          +a+
++++++++++++++