+++++++++++++
+ 0 +++  A  +
+    ++     +
+        ++++
+   +  +   ++
+A ++a ++  a+
+++++++++++++