++++++++
++   a++
++A   ++
++++A+++
++++ +++
++a  +++
+++A +++
++   +++
+a    ++
++++   +
++++++0+
++++++++