++++++++++
+A  +  A++
+++ + ++ +
+   +  + +
++  + +  +
+  ++ ++ +
+        +
+  a0a   +
++++++++++