+++++++++++
+    +++ a+
+ ++  +   +
+a+  A+   +
+++  +A +++
+++ 0  ++++
+++++++++++