++++++++++
+A  +  A++
+++ + ++ +
+a  +  + +
++  + +A +
+  ++ ++ +
+   a    +
+A a0a   +
++++++++++