+++++++++++++
+++++     a++
+++   A++ +++
++   ++    ++
++ +  0+  +++
++  +  +   ++
+  +  +   +++
+++++++++++++