+++++++++++++
+++++     a++
+++   A++ +++
++   ++    ++
++a+  0+  +++
++  +  +  A++
+ A+  +a  +++
+++++++++++++