+++++++++++++
+++++     a++
+++   A++ +++
++   ++A  a++
++a+  0+  +++
++  +  +  A++
+ A+  +a  +++
+++++++++++++