++++++++++++
++++++A+++++
++++    ++++
++A   a+++++
+++a  ++++++
+++++0 A++++
+++a   +++++
++++ A++++++
++a   a A+++
++++++++++++