+++++++++++++
+++++A  aaa++
+++A  A++a+++
++0 A++++++++
+++++++++++++