++++++++++
+B+b   +++
+  +++  ++
+  A+a +++
+  +++  ++
+  +++   +
+   0    +
++++++++++