++++++++++++++
++++++++++++++
++++++++++++++
+++++b   B++++
++++       +++
+++    0    ++
+++++B   b++++
++++++++++++++
++++++++++++++