++++++++++++++
++++++++++++++
++++++++++++++
+++++b   B++++
++++A     a+++
+++a   0   A++
+++++B   b++++
++++++++++++++
++++++++++++++