++++++++++++++
+++++     ++++
++b   0++   ++
+++   +++  +++
++B +    A+a +
+A+++  ++++  +
+  +a   ++   +
+  +    +    +
++    +   + ++
++++++++++++++
