+++++++++++++++
+    b a      +
+             +
+             +
+  a+    +b   +
+  +++  +++   +
+   +    +    +
+     0       +
+             +
+  ++   ++    +
+   ++ ++     +
+   B+++A     +
+             +
+             +
+    B A      +
+++++++++++++++
