+++++++++++++++
+++++++a+++++++
++++++   ++++++
+++++     +++++
++++  b a  ++++
+++         +++
++     0     ++
+A     A     B+
+++++++++++++++