+++++++++++++
++++     ++++
+B    0    ++
+++      ++++
++++   ++++++
+++ b      ++
+++++++   +++
++++     ++++
+++B    +++++
+++++     +++
+++b    +++++
+++++     +++
++++++   ++++
+++  A  +++++
+a     ++++++
+++++++++++++