+++++++++++++++
+++++++a+++++++
++++++   ++++++
+++++a   A+++++
++++  b a  ++++
+++B       b+++
++    a0b    ++
+A  B  A  A  B+
+++++++++++++++