+++++++++++++++
+++++++a+++++++
++++++   ++++++
+++++a   A+++++
++++  b a  ++++
+++B       b+++
++     0     ++
+A     A     B+
+++++++++++++++