+++++++++
++   0+++
+a   ++++
+++   b++
++     ++
+A     ++
+++    ++
++B   B++
++     ++
++A   a++
+      ++
+b    +++
+++++++++