+++++++++
++   0+++
+a   ++++
+++    ++
++     ++
+A     ++
+++    ++
++     ++
++     ++
++     ++
+      ++
+     +++
+++++++++