++++++++++
+a      A+
+ ++++++++
+0++++++++
++++++++++