++++++++++
+       A+
+       ++
+++++++ +
+     + +
+ ++ ++ +
+ +     +
+ +    a+
+0+++++++
+++