######
#    #
#  A0#
#    #
#   a#
######