######
#0   #
#    #
#  A #
#   a#
######