######
#  0 #
#  A #
#    #
#   a#
######