######
#    #
#  0 #
#  A #
#   a#
######