######
#    #
# 0A #
#    #
#   a#
######