######
#    #
#    #
#  0 #
#  Aa#
######