######
#   0#
#    #
#  A #
#   a#
######