######
#  # #
#  0 #
# #  #
#A# a#
######