######
#    #
#    #
#  A #
#  0a#
######