######
#    #
#   0#
#  A #
#   a#
######