######
#    #
#    #
# A0 #
#   a#
######