######
#    #
#    #
#  0A#
#   a#
######