######
#    #
#  #0#
#  # #
#aA# #
######