######
#    #
#  # #
#  # #
#aA#0#
######