######
#   0#
#  # #
#  # #
#aA# #
######