######
#    #
#    #
#  0 #
#A  a#
######