######
#    #
#0   #
#  A #
#   a#
######