######
#    #
#  # #
#  #0#
#aA# #
######