######
#    #
#    #
#  A0#
#   a#
######