######
#  0 #
#  # #
#A # #
#a # #
######