######
#    #
#  # #
#0 # #
#aA# #
######