######
#    #
#  # #
#A # #
#a #0#
######