######
#   0#
#  # #
#A # #
#a # #
######