######
#    #
#  #0#
#A # #
#a # #
######