######
#    #
# 0# #
#  # #
#aA# #
######