######
#    #
#  # #
# 0# #
#aA# #
######