######
#  0 #
#  # #
#  # #
#aA# #
######