######
# 0  #
#  # #
#  # #
#aA# #
######