######
#    #
#    #
#0 A #
#   a#
######