######
#   0#
#  # #
#  # #
#a #A#
######