######
#A   #
#  # #
#  # #
#a #0#
######