######
#    #
# 0# #
#  # #
#a #A#
######