######
#    #
#  #A#
#  # #
#a #0#
######