######
#    #
#  # #
#  #A#
#a #0#
######