######
#    #
#A # #
#  # #
#a #0#
######