######
#  A #
#  # #
#  # #
#a #0#
######