######
# A  #
#  # #
#  # #
#a #0#
######