######
#   A#
#  # #
#  # #
#a #0#
######