######
#    #
#  # #
#  # #
#a0#A#
######