######
#  A0#
# a# #
# #  #
#    #
######