######
#   A#
# a#0#
# #  #
#    #
######