######
# 0  #
#    #
#  A #
#   a#
######