######
#    #
# a# #
# #A #
#0   #
######