######
#    #
# a#A#
# # 0#
#    #
######