######
# A0 #
# a# #
# #  #
#    #
######