######
#    #
# a# #
# #0A#
#    #
######