######
#    #
# a# #
# #A #
# 0  #
######