######
#    #
#  # #
#  #0#
#a #A#
######