######
#   0#
# a# #
# #A #
#    #
######