######
#    #
# 0  #
#  A #
#   a#
######