######
#    #
# a# #
# #  #
#0A  #
######