######
#    #
# a# #
# #A #
#   0#
######