######
#    #
#0a# #
#A#  #
#    #
######