######
#    #
# a# #
# #A #
#  0 #
######