######
#0   #
#Aa# #
# #  #
#    #
######