######
#    #
# a# #
# #  #
# 0A #
######