######
#A0  #
# a# #
# #  #
#    #
######