######
#  # #
# 0  #
# #  #
# #Aa#
######