######
#0   #
# a# #
# #A #
#    #
######