######
#    #
#    #
# 0A #
#   a#
######