######
#  # #
#    #
#0#  #
# #Aa#
######