######
#    #
#0a# #
# #A #
#    #
######