######
#  0 #
# a# #
# #A #
#    #
######