######
#  # #
#    #
# #  #
#0#Aa#
######