######
#  # #
#0   #
# #  #
# #Aa#
######