######
#  # #
#    #
# # 0#
# #Aa#
######