######
#0 # #
#    #
# #  #
# #Aa#
######