######
#  # #
#   0#
# #  #
# #Aa#
######