######
# 0# #
#    #
# #  #
# #Aa#
######