######
#  # #
#    #
# #0 #
# #Aa#
######