######
#  # #
#  0 #
# #A #
# # a#
######