######
#  0 #
#    #
#  A #
#   a#
######