######
#  # #
#   0#
# #A #
# # a#
######