######
#  # #
#    #
# #A #
# #0a#
######