++++++++++++
+0A        +
+          +
+          +
+          +
+          +
+         a+
++++++++++++