+++++++++
+      a+
+       +
+  0A   +
+ +++++++
+A      +
+       +
+      a+
+++++++++