+++++++++
+      a+
+       +
+A      +
+ +++++++
+0A     +
+       +
+      a+
+++++++++