+++++++++
+0 A   a+
+  A   a+
+  A   a+
+  A   a+
+++++++++
