+++++++++++++++++++
+0 A              +
+              ++++
+                 +
+              ++A+
+               +a+
+++++++++++++++++++
