++++++++++++++++++++++++++++++++++++++++++++++++++++++++++++++++++++++
+                                                                    +
+ ++++++++++++++++++++++++++++++++++++++++++++++++++++++++++++++++++ +
+                                                                    +
+0 Aa                                                                +
+                                                                    +
+ ++++++++++++++++++++++++++++++++++++++++++++++++++++++++++++++++++ +
+A                                                                   +
++++++++++++++++++++++++++++++++++++++++++++++++++++++++++++++++++++++