+++++++++++++++
+     a       +
+             +
+             +
++  +++  +    +
+       +  A  +
+   +   +     +
+   +   +++++++
+        +    +
+             +
+  ++   +     +
+   +   ++    +
+  +          +
+        0    +
+++++++++++++++