+++++++++
+  a    +
+  A0   +
+   +++++
+       +
+++     +
+       +
+       +
+++++++++