+++++++++++
+         +
+0   a    +
+         +
+         +
+         +
+         +
+         +
+    A    +
+++++++++++