+++++++++++
+    0    +
+    a    +
+         +
+         +
+         +
+         +
+         +
+    A    +
+++++++++++