+++++++++++
+         +
+0        +
+         +
+         +
+         +
+   A     +
+         +
+a        +
+++++++++++