+++++++++++
+         +
+0        +
+         +
+         +
+         +
+         +
+        A+
+a        +
+++++++++++