+++++++++++
+         +
+0        +
+        A+
+         +
+         +
+         +
+         +
+a        +
+++++++++++