++++++++++++
+          +
+    a     +
+          +
+++++++    +
+          +
+   +      +
+   +      +
+   ++++++++
+          +
+     A   0+
++++++++++++