++++++++++++
+    0     +
+    a     +
+    A     +
+++++++    +
+          +
+   +      +
+   +      +
+   ++++++++
+          +
+          +
++++++++++++