+++++++++++++
+     a     +
+           +
+           +
+++++++     +
+   A       +
+   +       +
+   +       +
+   +++++0+++
+           +
+  ++       +
+   +       +
+++++++++++++