+++++++++++++
+     a     +
+           +
+ A         +
+++++++     +
+           +
+   +       +
+   +       +
+   +++++0+++
+           +
+  ++       +
+   +       +
+++++++++++++