+++++++++++++++
+0            +
++++++++++++  +
+             +
+++++++  ++   +
+           +++
+     +++++++++
+     +A      +
+             +
++++++++      +
+        ++++++
+        +    +
+        + +  +
+   ++++++ +  +
+          + a+
+++++++++++++++