blue: A,1
red: B,0
++++++++++
+      Aa+
+        +
+    0   +
+     ++++
+        +
+        +
+    1++++
+        +
+      Bb+
++++++++++