blue: A,D,1,3
red: B,C,0,2
++++++++++
+a      b+
+        +
+   10   +
+   AB   +
+   CD   +
+   23   +
+        +
+c      d+
++++++++++