+++++++++++++++
+0A           +
+             +
+             +
+             +
+             +
+             +
+             +
+             +
+             +
+             +
+             +
+             +
+             +
+            a+
+++++++++++++++