++++++++
+0A    +
+      +
+      +
+     a+
++++++++
