++++++++++
+0A      +
+        +
+        +
+        +
+        +
+        +
+       a+
++++++++++