++++++++++
+       A+
+       ++
+       +
+       +
+       +
+     a +
+       +
+0+++++++
+++