+++++++++
+      a+
+      A+
+      0+
+ +++++++
+A      +
+       +
+      a+
+++++++++