+++++++++
+ A    a+
+       +
+       +
+ +++++++
+      0+
+      A+
+      a+
+++++++++