++++++++++++++++
+0A            +
+              +
+              +
+              +
+              +
+              +
+              +
+              +
+             a+
++++++++++++++++