++++++++++++++
+0A          +
+            +
+            +
+            +
+            +
+            +
+            +
+            +
+            +
+            +
+            +
+           a+
++++++++++++++