+++++++++++
+0A       +
+         +
+         +
+         +
+         +
+         +
+         +
+        a+
+++++++++++