++++++++++
+   +   A+
++     +++
+  +   +++
+ + a+ +++
+   +  +++
+   +  +++
+ ++++++++
+0++++++++
++++++++++